type octile
height 1
width 8
map
@O..GTSW
